R 400 800
F 252,192,255
C 246,221,128
S ./textures/barrel.xpm

NO ./textures/pinkwall.xpm
SO ./textures/lightgreen.xpm
WE ./textures/lightblue.xpm
EA ./textures/purplewall.xpm

        1111111111111111111111111
        10000000001100000S0000001
        1011000001110000000000001
        1001000000000000000000001
111111111011000001110000000000001
100000000011000001110111100011111
11110111111111011100000010201
11110111111111011101010010001
10000000000000001100000010001
10000000000000001101010010001
1100000111010101111101111000111
11110111 1110101 101111010001
11111111 1111111 111111111111